9 9
#G#######
#       #
### # ###
### #   #
#   ### #
# ###   #
# # ### #
# #     #
#########